1 1 1 1 0 1 1 1 1
1 1 1 1 1 1 1 1 1
1 1 1 1 30 1 1 1 1
1 1 1 1 1 1 1 1 1
1 1 1 1 1 1 1 1 1
1 1 1 1 1 1 1 1 1
1 1 1 30 30 30 1 1 1
1 1 1 1 1 1 1 1 1
1 1 1 1 100 1 1 1 1