0 1 1 1 1 1 1 1 1
1 1 1 1 1 1 1 1 1
1 1 1 1 30 1 1 1 1
1 1 1 1 1 1 1 1 1
1 1 1 1 1 1 1 1 1
2 2 2 30 30 30 2 1 1
1 1 1 1 1 1 1 1 1
1 1 1 1 2 1 1 1 1
1 1 1 1 100 2 1 1 1